32 18 
340 140 
10 10 1 1 1 1 1 1 1 1 3 3 3 3 4 4 4 3 3 3 1 1 1 1 1 1 1 1 1 2 2 2 
10 1 1 1 1 1 1 1 1 1 3 1 3 3 8 8 8 3 3 3 3 1 1 1 1 1 1 1 1 2 2 2 
1 1 1 1 1 1 1 1 1 1 3 1 3 3 8 8 8 3 3 3 1 1 1 1 1 1 1 1 1 1 2 2 
1 1 1 1 1 1 1 1 1 1 3 1 1 3 4 4 4 3 3 3 3 1 1 1 1 1 1 1 1 1 1 1 
1 1 1 1 1 1 1 1 1 1 1 1 1 3 4 4 4 3 3 3 3 1 1 1 1 1 1 1 1 1 1 1 
1 1 1 1 1 1 1 1 1 1 1 1 1 3 4 11 4 3 3 1 1 1 1 1 1 1 1 1 1 1 1 1 
1 1 1 1 1 1 1 1 1 1 1 1 3 3 4 4 4 3 1 1 1 1 1 1 1 1 1 1 1 1 1 1 
1 1 1 1 1 1 1 1 1 1 1 3 3 3 4 4 4 3 1 1 1 1 1 1 1 1 1 1 1 1 1 1 
1 1 1 1 1 1 1 1 1 1 1 3 3 3 8 8 8 3 1 1 1 1 1 1 5 5 5 1 1 1 1 1 
1 1 1 1 2 2 1 1 1 1 1 1 3 3 8 8 8 3 1 1 1 1 1 1 1 1 5 5 1 1 1 1 
1 1 1 2 2 2 2 1 1 1 1 1 1 3 4 4 4 3 1 1 1 1 1 1 1 1 5 5 1 1 1 1 
1 1 1 2 2 2 2 1 1 1 1 1 1 3 4 11 4 3 3 3 3 1 1 1 1 1 5 5 1 1 1 1 
1 1 1 1 1 1 1 1 1 1 1 1 1 3 4 4 4 3 3 3 3 1 1 1 1 1 1 1 1 1 1 1 
1 1 1 1 1 1 1 1 1 1 1 1 3 3 4 4 4 3 1 3 3 1 1 1 1 1 1 1 1 1 1 1 
1 1 1 1 1 1 1 1 1 1 1 3 3 3 8 8 8 3 3 1 1 1 1 1 7 1 1 1 1 1 1 1 
1 1 1 1 1 1 1 1 1 1 3 3 3 3 8 8 8 3 3 3 3 1 1 7 7 7 1 1 1 1 1 1 
1 1 1 1 6 6 6 1 1 1 1 3 3 3 4 4 4 3 3 3 1 1 7 7 7 7 7 1 1 1 1 1 
1 1 1 1 1 1 1 1 1 1 1 1 3 3 4 4 4 3 1 3 1 1 1 7 7 7 1 1 1 1 1 1 
