32 18 
340 140 
4 4 4 4 4 4 4 3 1 1 1 1 1 1 1 1 1 1 1 1 1 1 1 1 3 4 4 4 4 4 4 4 
4 4 4 4 4 4 3 1 1 1 1 1 1 1 1 1 1 1 1 1 1 1 1 1 1 3 4 4 4 4 4 4 
4 4 4 4 4 3 1 1 1 1 1 1 1 1 1 1 5 1 1 1 1 1 1 1 1 1 3 4 4 4 4 4 
4 4 4 4 3 1 1 1 1 1 1 1 1 1 1 1 5 1 1 1 1 1 1 1 1 1 1 3 4 4 4 4 
4 4 4 3 1 1 1 1 1 1 1 1 1 1 1 1 5 1 1 1 1 1 1 1 1 1 1 1 3 4 4 4 
4 4 3 1 1 1 1 1 1 1 1 1 1 1 3 3 3 1 1 1 1 1 1 1 1 1 1 1 1 3 4 4 
4 3 1 1 1 1 1 1 1 1 1 1 1 1 3 4 3 3 1 1 1 1 1 1 1 1 1 1 1 1 3 4 
3 1 1 1 1 1 1 1 1 1 1 1 1 1 3 4 4 3 3 3 1 1 1 1 1 1 1 1 1 1 1 3 
1 1 1 1 1 1 1 1 1 5 5 5 3 3 4 4 4 4 4 3 1 1 1 1 1 1 1 1 1 1 1 1 
1 1 1 1 1 1 1 1 1 1 1 1 3 4 4 4 4 4 3 3 5 5 5 1 1 1 1 1 1 1 1 1 
3 1 1 1 1 1 1 1 1 1 1 1 3 3 3 4 4 3 3 1 1 1 1 1 1 1 1 1 1 1 1 3 
4 3 1 1 1 1 1 1 1 1 1 1 1 1 3 3 4 3 1 1 1 1 1 1 1 1 1 1 1 1 3 4 
4 4 3 1 1 1 1 1 1 1 1 1 1 1 1 3 3 3 1 1 1 1 1 1 1 1 1 1 1 3 4 4 
4 4 4 3 1 1 1 1 1 1 1 1 1 1 1 5 1 1 1 1 1 1 1 1 1 1 1 1 3 4 4 4 
4 4 4 4 3 1 1 1 1 1 1 1 1 1 1 5 1 1 1 1 1 1 1 1 1 1 1 3 4 4 4 4 
4 4 4 4 4 3 1 1 1 1 1 1 1 1 1 5 1 1 1 1 1 1 1 1 1 1 3 4 4 4 4 4 
4 4 4 4 4 4 3 1 1 1 1 1 1 1 1 1 1 1 1 1 1 1 1 1 1 3 4 4 4 4 4 4 
4 4 4 4 4 4 4 3 1 1 1 1 1 1 1 1 1 1 1 1 1 1 1 1 3 4 4 4 4 4 4 4 
