32 18 
340 140 
0 1 1 1 1 0 1 1 3 1 1 1 1 1 1 1 1 1 1 0 6 0 1 1 1 1 1 1 1 1 1 1 
1 3 1 1 1 1 3 1 1 1 5 0 1 1 0 1 1 1 0 1 3 1 1 1 0 1 1 1 3 1 1 1 
0 3 1 1 1 3 1 3 1 1 1 3 3 1 1 3 0 1 1 1 1 1 1 1 1 1 1 1 3 1 1 1 
1 1 1 1 1 1 0 1 1 0 3 1 1 3 1 0 1 1 1 3 1 0 0 1 3 0 0 1 0 1 1 1 
1 1 0 3 1 1 0 0 6 0 1 1 1 5 1 0 1 5 1 1 0 1 1 1 1 3 1 1 0 3 1 1 
1 1 0 1 1 5 1 1 1 1 1 3 1 3 1 1 1 1 3 1 0 1 1 5 1 0 3 0 1 0 3 1 
1 1 1 0 1 1 1 3 3 1 0 1 1 3 1 0 1 1 1 1 3 1 1 0 1 1 6 1 3 1 1 3 
1 0 1 1 1 1 3 0 1 1 1 1 1 0 0 1 1 3 1 1 1 1 5 3 0 0 3 1 1 3 1 1 
1 1 3 1 0 1 1 1 1 3 1 1 0 1 1 1 0 1 1 3 1 1 0 1 3 1 3 0 1 3 1 1 
1 3 0 1 1 1 3 0 1 0 5 1 3 1 0 1 1 1 6 1 1 1 1 0 1 1 1 1 5 1 1 1 
3 1 1 3 1 3 1 1 3 1 1 1 1 1 0 1 3 0 0 1 0 1 1 1 1 0 1 3 0 1 1 1 
1 1 0 1 1 6 0 1 1 1 0 1 1 1 3 1 1 0 3 1 1 1 3 1 1 0 1 1 1 1 1 0 
0 1 1 1 3 0 1 1 1 3 0 3 3 1 1 3 1 1 1 1 1 1 0 1 1 1 1 1 6 0 1 1 
1 1 0 1 1 1 1 3 1 1 0 1 1 3 0 1 0 1 1 5 1 1 1 1 1 1 1 1 0 3 0 1 
1 1 6 1 5 3 1 1 0 1 1 0 1 5 1 1 3 3 0 1 3 1 1 1 3 1 3 1 1 3 1 1 
1 1 0 1 1 1 3 0 1 1 0 1 1 1 0 1 1 1 0 0 1 1 0 0 0 1 5 1 1 1 1 1 
0 1 3 1 1 0 1 6 3 1 1 1 1 1 1 1 1 1 0 1 1 1 1 3 1 1 1 1 1 1 1 1 
0 1 1 1 1 1 1 1 1 1 3 3 1 1 3 1 1 3 1 3 1 1 1 1 1 1 1 1 1 1 1 1 
