32 18 
340 120 
1 1 1 1 1 1 1 1 1 1 1 1 1 1 1 1 1 1 1 1 1 1 1 1 1 1 1 1 1 1 1 1 
1 1 1 1 1 1 1 1 1 1 1 1 1 1 1 1 1 1 1 1 1 1 1 1 1 1 1 1 1 1 1 1 
1 1 1 1 1 1 1 1 1 1 1 1 1 1 1 1 1 1 1 1 1 1 1 1 1 1 1 1 1 1 1 1 
1 1 1 1 6 6 6 6 1 1 5 1 1 1 1 1 1 1 1 1 1 5 1 6 6 6 6 1 1 1 1 1 
1 1 1 1 6 6 6 6 1 1 1 1 1 1 1 1 1 1 1 1 1 1 1 6 6 6 6 1 1 1 1 1 
1 1 1 1 6 6 1 1 1 1 1 1 1 1 1 1 1 1 1 1 1 1 1 1 1 6 6 1 1 1 1 1 
1 1 1 1 6 6 1 1 1 1 1 3 3 3 3 3 3 3 3 3 3 1 1 1 1 6 6 1 1 1 1 1 
1 1 1 1 1 1 1 1 1 1 1 3 4 4 4 4 4 4 4 4 3 1 1 1 1 1 1 1 1 1 1 1 
1 1 1 1 1 1 1 1 1 1 3 4 4 4 4 4 4 4 4 4 4 3 1 1 1 1 1 1 1 1 1 1 
1 1 1 1 1 1 1 1 1 1 3 8 8 8 8 8 8 8 8 8 8 3 1 1 1 1 1 1 1 1 1 1 
1 1 1 1 1 1 1 1 1 1 3 4 4 4 4 4 4 4 4 4 4 3 1 1 1 1 1 1 1 1 1 1 
1 1 1 1 6 6 1 1 1 1 1 3 4 4 4 4 4 4 4 4 3 1 1 1 1 6 6 1 1 1 1 1 
1 1 1 1 6 6 1 1 1 1 1 3 3 3 3 3 3 3 3 3 3 1 1 1 1 6 6 1 1 1 1 1 
1 1 1 1 6 6 6 6 1 1 1 1 1 1 1 1 1 1 1 1 1 1 1 6 6 6 6 1 1 1 1 1 
1 1 1 1 6 6 6 6 1 1 1 1 1 1 1 1 1 1 1 1 1 1 1 6 6 6 6 1 1 1 1 1 
1 1 1 1 1 1 1 1 1 1 5 1 1 1 1 1 1 1 1 1 1 5 1 1 1 1 1 1 1 1 1 1 
1 1 1 1 1 1 1 1 1 1 1 1 1 1 1 1 1 1 1 1 1 1 1 1 1 1 1 1 1 1 1 1 
1 1 1 1 1 1 1 1 1 1 1 1 1 1 1 1 1 1 1 1 1 1 1 1 1 1 1 1 1 1 1 1 
