32 18 
340 140 
10 10 10 1 1 1 1 1 1 1 1 1 1 1 1 1 1 1 1 1 1 1 1 1 1 1 1 1 1 1 1 1 
10 10 1 1 1 1 1 1 1 1 1 1 1 1 1 1 1 1 1 1 1 1 1 1 1 1 1 1 1 1 1 1 
10 1 1 1 1 1 1 1 1 1 1 1 1 1 1 1 1 1 1 1 1 9 9 9 9 9 1 1 1 1 1 1 
1 1 1 1 1 1 1 9 9 9 9 9 9 1 1 1 1 1 1 1 1 11 11 5 5 9 1 1 1 1 1 1 
1 1 1 1 1 1 1 9 11 5 5 5 9 1 1 1 1 1 1 1 1 9 2 2 5 9 1 1 1 1 1 1 
1 1 1 1 1 9 9 9 5 5 5 5 9 1 1 1 1 1 1 9 9 9 2 2 5 9 1 1 1 1 1 1 
7 7 7 7 7 9 9 9 9 9 9 9 9 7 7 7 7 7 7 9 5 5 5 5 5 9 7 7 7 7 7 7 
7 7 7 7 7 7 3 3 7 7 7 3 3 7 7 7 7 7 7 9 9 9 9 9 9 6 6 6 6 6 6 7 
7 7 7 7 7 7 3 3 7 7 7 3 3 7 7 7 7 7 7 3 3 7 7 7 7 7 3 3 7 3 3 7 
7 7 7 7 7 7 7 7 7 7 7 7 7 7 7 7 7 7 7 3 3 7 7 7 7 7 3 3 7 3 3 7 
7 7 7 7 7 7 7 7 7 7 7 7 7 7 7 7 7 7 7 7 7 7 7 7 7 7 7 7 7 7 7 7 
1 1 1 1 1 1 1 1 1 1 1 1 1 1 1 1 1 1 1 1 1 1 1 1 1 1 1 1 1 1 1 1 
1 1 1 1 1 1 1 1 1 1 1 1 1 1 1 1 1 1 1 1 1 1 1 1 1 1 1 1 1 1 1 1 
1 1 1 1 1 1 1 1 1 1 1 1 1 1 1 1 1 1 1 1 1 1 1 1 1 1 1 1 1 1 1 1 
3 3 3 3 3 3 3 3 3 3 3 3 3 3 3 3 3 3 3 3 3 3 3 3 3 3 3 3 3 3 3 3 
4 4 3 3 3 3 4 4 4 4 4 4 4 4 4 4 4 4 4 4 4 4 4 4 4 4 3 3 4 4 4 4 
4 4 4 4 4 4 4 4 4 4 4 4 4 4 4 4 4 4 4 4 4 4 4 4 4 4 3 3 3 4 4 4 
4 4 4 4 4 4 4 4 4 4 4 4 4 4 4 4 4 4 4 4 4 4 4 4 4 4 3 3 3 4 4 4 
