32 18 
340 140 
1 1 1 1 1 1 1 1 1 1 1 1 0 1 1 1 1 1 0 0 0 1 1 1 1 1 1 1 1 1 1 1 
1 1 1 1 1 1 1 1 1 0 0 0 0 1 1 1 1 1 1 0 0 1 1 1 1 1 1 1 1 1 1 1 
1 1 1 1 1 1 1 1 0 0 0 0 0 1 1 1 1 1 1 1 0 1 1 1 1 1 1 1 1 1 1 1 
1 1 1 1 1 1 1 2 2 2 2 2 2 2 2 2 2 1 1 1 1 1 1 1 1 1 0 5 5 1 1 1 
1 1 1 1 1 1 1 2 0 0 0 0 1 1 1 1 1 1 1 1 1 1 1 1 1 0 0 5 5 1 1 1 
1 5 1 1 1 1 0 2 0 0 0 0 1 1 1 1 1 1 1 1 1 1 1 1 1 0 0 0 1 1 1 1 
1 1 5 1 1 0 0 2 0 0 0 1 5 1 1 1 1 1 1 1 1 1 1 1 1 1 1 1 1 1 1 1 
1 1 1 1 1 0 0 2 0 0 0 1 5 1 1 1 1 1 0 0 1 1 1 1 1 1 1 1 1 1 1 1 
1 1 1 1 0 0 0 2 0 0 0 1 5 1 1 1 1 0 0 0 0 1 1 1 1 1 1 1 1 3 3 3 
1 1 1 1 1 0 0 2 0 0 1 1 5 1 1 1 1 0 0 1 0 1 1 1 1 1 1 1 3 3 3 3 
1 1 1 1 1 0 0 2 0 1 1 1 5 1 1 1 0 0 0 1 1 1 1 1 1 1 1 1 3 3 3 4 
1 1 1 1 1 1 0 2 1 1 1 1 5 1 1 1 0 0 0 1 1 1 1 1 1 1 1 3 3 3 4 4 
1 1 1 1 1 1 0 2 1 1 1 1 5 1 1 1 0 0 0 1 1 1 1 1 1 1 1 3 3 3 4 4 
1 1 1 1 1 1 1 2 1 1 5 5 5 1 1 1 0 0 1 1 1 1 1 1 1 1 1 3 3 3 4 4 
1 1 1 1 1 1 1 2 1 1 1 1 1 1 1 1 1 1 1 1 1 1 1 1 1 1 3 3 3 4 4 4 
1 1 5 1 1 1 1 2 1 1 1 1 1 1 1 1 1 1 1 1 1 1 1 1 1 3 3 3 4 4 4 4 
1 1 1 1 1 1 1 2 2 2 2 2 1 1 1 1 1 1 1 1 1 1 1 3 3 3 4 4 4 4 4 4 
1 1 1 1 1 1 1 2 2 2 2 2 1 1 1 1 1 1 1 1 1 1 3 3 4 4 4 4 4 4 4 4 
